............................
............................
............................
............................
R..........................L
#..........................#
#..p....#...........Y......#
#==========================#
############################
